---------------------
-#--#--#--#--#--#--#-
---------------------
---------------------
-#--P-----B-----O--#-
---------------------
---------------------
-#--#--#--#--#--#--#-
---------------------