---------------------
-#--#--#--#--#--#--#-
---------------------
---------------***---
-#--P-----x----b-o-#-
---------------***---
---------------------
-#--#--#--#--#--#--#-
---------------------