---------------------------
-#--#--#--#--#--#--#--#--#-
---------------------------
---------------------------
-#-----x-----#-----------#-
---------------------------
------------***------------
-#-----B-----------------#-
------------***------------
---------------------------
-#-----P-----#-----X--O--#-
---------------------------
---------------------------
-#--#--#--#--#--#--#--#--#-
---------------------------