------------------
-#--#--#--#--#--#-
------------------
------------------
-#--------b--#--#-
------------------
---------*-*------
-#--x--#-*-*-#--#-
---------*-*------
-------------**---
-#--P--B--------#-
-------------O----
------------------
-#--X--#--B-***-#-
------------***---
------------------
-#-----------#--#-
------------------
------------------
-#--#--#--#--#--#-
------------------