------------------
-#--#--#--#--#--#-
------------------
------*********---
-#--P-*********-#-
------------------
----------B--O----
-#--B-----------#-
------*********---
------------------
-#--x--#--#--#--#-
------------------
------------------
-#--#--#--#--#--#-
------------------