---------------------
-#--#--#--#--#--#--#-
---------------------
---------***---------
-#-------bbb-B--O--#-
---------***---------
---------------------
-#--------#--#--#--#-
---------------------
---------------------
-#--------x--------#-
---------------------
---------------------
-#-----B--B--B-----#-
---------------------
---------------------
-#-----P-----X-----#-
---------------------
---------------------
-#--#--#--#--#--#--#-
---------------------