---------------------------
-#--#--#--#--#--#--#--#--#-
---------------------------
---------------------------
-#--#--#--#--#-----------#-
---------------------------
---------------------------
-#--o--P--B--B-----O--x--#-
---------------------------
---------------------------
-#--#--#--#--#-----------#-
---------------------------
---------------------------
-#--#--#--#--#--#--#--#--#-
---------------------------