---------------------
-#--#--#--#--#--#--#-
---------------------
---------------------
-#--#--#--#--------#-
---------------O-----
---------------------
-#-----------------#-
---------------------
---------------------
-#-----B--B-----#--#-
---------------------
---------------------
-#--X--P--B-----#--#-
---------------------
---------------------
-#-----x--------#--#-
---------------------
---------------------
-#--#--#--#--#--#--#-
---------------------