------------------------
-#--#--#--#--#--#--#--#-
------------------------
------------*********---
-#--------P-*********-#-
------------------------
------------------------
-#-----B--------------#-
------------****---**---
---------------*-B-**---
-#--x--B-----#-*---**-#-
---------------*---**---
---------------*-O-**---
-#--------X--#-*---**-#-
---------------******---
------------------------
-#--#--#--#--#--#--#--#-
------------------------