---------------------------
-#--#--#--#--#--#--#--#--#-
---------------------------
---------------------------
-#--#--#--#-----P--#--#--#-
---------------------------
---------------------------
-#--------B--------B--X--#-
---------------------------
---------------------*-*---
-#-----------O--o--x---*-#-
---------------------***---
---------------------------
-#--#--#--#--#--#--#--#--#-
---------------------------