---------------------
-#--#--#--#--#--#--#-
---------------------
------*********------
-#--#-**-----**-#--#-
------**-***-**------
------------b**------
-#--p--X--B--o*-#--#-
----b--------**------
---------------------
-#--#--#--#--#--#--#-
---------------------