---------------
-#--#--#--#--#-
---------------
---------------
-#--X--------#-
---------------
---------------
-#--p--B--O--#-
---------------
---------------
-#--#--#--#--#-
---------------