---------------------
-#--#--#--#--#--#--#-
---------------------
---------------------
-#--------------o--#-
---------------------
---------------------
-#----------B------#-
-------B--------O----
---------------------
-#-----------------#-
---------------------
---------------------
-#--P--x----O---b--#-
---------------------
---------------------
-#--#--#--#--#--#--#-
---------------------