------------------
-#--#--#--#--#--#-
------------------
---***------------
-#-----O--#--#--#-
-----*------------
------------------
-#--x-----#--#--#-
------------------
------------------
-#--O--P--------#-
------------------
------------------
-#--B--X--B-----#-
------------------
------------------
-#--------#--#--#-
------------------
------------------
-#--#--#--#--#--#-
------------------