------------------
-#--#--#--#--#--#-
------------------
------------------
-#--#--O--#--#--#-
------------------
------------------
-#--------#--#--#-
------------------
------------------
-#--B--X--P-----#-
------------------
------------------
-#--O-----B-----#-
------------------
---------*-*------
-#-----x---*-#--#-
-----------*------
------------------
-#--#--#--#--#--#-
------------------