---------------
-#--#--#--#--#-
---------------
---------------
-#-----B--O--#-
---------------
---------------
-#--P--------#-
---------------
---------------
-#--#--#--#--#-
---------------