---------------------
-#--#--#--#--#--#--#-
---------------------
------------o**------
-#--#--#--#--**-#--#-
-------------**------
----------**----**---
-#--X--B-bbb-B--**-#-
----------**----**---
---*-----------------
-#-*---#--#-----#--#-
---*-----------------
---------------------
-#--p--b--b-----#--#-
---------------------
---------------------
-#--#--#--#--#--#--#-
---------------------