---------------------
-#--#--#--#--#--#--#-
---------------------
---------------------
-#-----x-----#--#--#-
---------------------
---------------------
-#--P--B--------X--#-
---------------------
---------------------
-#-----------#--B--#-
---------------------
---------------bbb---
-#--#--#--#--#-ooo-#-
---------------------
---------------------
-#--#--#--#--#--#--#-
---------------------