---------------
-#--#--#--#--#-
---------------
---------***---
-#--x----b-o-#-
---------***---
---------------
-#--P-----#--#-
---------------
---------------
-#--#--#--#--#-
---------------