---******------------
-#-***---------------
---------------------
**-------------------
**--P--B--------X----
**-------------------
*--------------------
*--------------------
*--------------------
---------------------
-------b--------x----
---------------------
---------------------
---------------------
---------------------
