---******------------
-#-***---------------
---------------------
**-------------------
**--P--B-----X-------
**-------------------
*--------------------
*------O-------------
*--------------------
---------------------
-------b-----x-------
---------------------
---------------------
-------o-------------
---------------------
