---******------------
-#-***---------------
---------------------
**-------------------
**--P--B-------------
**-------------------
*--------------------
*--------------------
*--------------------
---------------------
-------b-------------
---------------------
---------------------
---------------------
---------------------
