---******------------
-#-***---------------
---------------------
**-------------------
**--S----------------
**-------------------
*--------------------
*--------------------
*--------------------
---------------------
---------------------
---------------------
---------------------
---------------------
---------------------
